~~~~~~~~~~~~~~~~~~~~~~~~~~~~~~~~~~~~~~~~~~~~~~~~~~~~~~~~~~~~~~~~~~~~~~~~~~~~~~~~~~~~~~~~~~~~~~~~~~~~~~~~~~~~~~~~~~~~~~~~~~~~~~~~~~~~~~~~~~~~~~~
~~~~~~~~~~~~~~~~~~~~~~~~~~~~~~~~~~~~~~~~~~~~~~~~~~~~~~~~~~~~~~~~~~~~~~~~~~~~~~~~~~~~~~~~~~~~~~~~~~~~~~~~~~~~~~~~~~~~~~~~~~~~~~~~~~~~~~~~~~~~~~ 
~~~~~~~~~~~~~~~~~~~~~~~~~~~~~~~~~~~~~~~~~~~~~~~~~~~~~~~~~~~~~~~~~~~~~~~~~~~~~~~~~~~~~~~~~~~ ~~~~~~~~~~~~~~~~~~~~~~~~~~~~~~~~~~~~~~~~~~~~~~~~~~ 
~~~~~~~~~~~~~~~~~~~~~~~~~~~~~~~~~~~~~~~~~~~~~~~~~~~~~~~~~~~~~~~~~~~~~~~~~~~~~~~~~~~~   ~ ~       ~~~~~~~~~~~~~~~~~~~~~~~~~~~~~~~~~~~~~         
~~~~~~~~~~~~~~~~~~~~~~~~~~~~~~~~~~~~~~~~~~~~~~~~~~~~~~~~~~~~~~~~~~~~~~~~~~~~~           ~    ~~   ~  ~~~~~~~~~~~~~~~~~~~~~~~~~~~~~             
~~~~~~~~~~~~~~~~~~~~~~~~~~~~~~~~~~~~~~~~~~~~~~~~~~~~~~~~~~~~~~~~~~~~~~~~~~    ~~             ~            ~~~~~~~~~~~~~~~~~~~~~                
~~~~~~~~~~~~~~~~~~~~~~~~~~~~~~~~~~~~~~~~~~~~~~~~~~~~~~~~~~~~~~~~~~~~~~~~ ~                                    ~~~~~~~~~~   ~~~~~~~             
~~~~~~~~~~~~~~~~~~~~~~~~~~~~~~~~~~~~~~~~~~~~~~~~~~~~~~~~~~~~~~~~~~~~~~                                            ~~~~~~  ~~~~~                
~~~~~~~~~~~~~~~~~~~~~~~~~~~~~~~~~~~~~~~~~~~~~~~~~~~~~~~~~~~~~~~~~~~                                 ~              ~~~~~   ~~                  
~~~ ~ ~~     ~~  ~~~~~~~~~~~~~~~~~~~~~~~~~~~~~~~~~~~~~~~~~~~~~~~~~                                     ~~~~~~  ~~~~   ~~                       
~~~~~               ~~~~~~~~~~~~~~~~~~~~~~~~~~~~~~~~~~~~~~~~~~~~~~  ~            ~~~~~~                ~~~~~~~~~~                              
~~~~~~             ~~~~~~~~~~~~~~~~~~~~~~~~~~~~~~~~~~~~~~~~~~~~~                 ~~~~~         ~        ~~~~                                   
~~~~~~~~~    ~~~~~~~~~~~~~~~~~~~~~~~~~~~~~~~~~~~~~~~~~~~~~~~~ ~               ~~~~~                                                            
~~~~~~~~~~~~~~~~~~~~~~~~~~~~~~~~~~~~~~~~~~~~~~~~~~~~~~~~~~                 ~~~~~~                                                              
~~~~~~~~~~~~~~~~~~~~~~~~~~~~~~~~~~~~~~~~~~~~~~~~~~~~~~~~                 ~~~~~~~~~                                                             
~~~~~~~~~~~~~~~~~~~~~~~~~~~~~~~~~~~~~~~~~~~~~~~~~~~~~                    ~~~~~~~~~~                                                            
~~~~~~~~~~~~~~~~~~~~~~~~~~~~~~~~~~~~~~~~~~~~~~~~~~~~~~                      ~~~~~~~~~~~~~~~~~~~~                                               
~~~~~~~~~~~~~~~~~~~~~~~~~~~~~~~~~~~~~~~~~~~~~~~~~~~~~~~     ~~~~           ~~~~~~~~~~      ~                                                   
~~~~~~~~~~~~~~~~~~~~~~~~~~~~~~~~~~~  ~~~~~~~~~~~~~~~~~~~~~~~~~~~        ~~~~~~~~~~~~~~~~                                                       
~~~~~~~~~~~~~~~~~~~~~~~~~~~~~~~~~~      ~~~~~~~~~~~~~~~~~~   ~~~~       ~~~~~~~~~   ~                                                          
~~~~~~~~~~~~~~~~~~~~~~~~~~~~~~~~~~~~      ~~~~~~~~~~~~~~~~   ~~~~~  ~~~~~~~~~~~~                                                               
~~~~~~~~~~~~~~~~~~~~~~~~~~~~~     ~~~~     ~~~~~~~~~~~~~~~~  ~~~ ~~~~~~~~~~~~~                                                                 
~~~~~~~~~~~~~~~~~~~~~~~~~~~      ~~~~~~     ~~~~~~~~~~~~~~          ~                                                                          
~~~~~~~~~~~~~~~~~~~~~~~~~~~      ~~~~          ~~~~~                                                                                           
~~~~~~~~~~~~~~~~~~~~~~~~~~~~~~~~~~~~~~~      ~~~~~~ ~                                                                                          
~~~~~~~~~~~~~~~~~~~~~~~~~~~~~~~~~~~~~~~~~~~~~~                                                                               ~~ ~~~~           
~~~~~~~~~~~~~~~~~~~~~~~~~~~~~~~~~~~~~~~~~                                                                                   ~~~~~~~~~          
~~~~~~~~~~~~~~~~~~~~~~~~~~~~~~~~~~~~~~~                                                                                        ~~~~~~~         
~~~~~~~~~~~~~~~~~~~~~~~~~~~~~~~~~~~~~~~~~~                                                   ~  ~~~     ~~~~~~                  ~~~~~          
~~~~~~~~~~~~~~~~~~~~~~~~~~~~~~~~~~~~~~~~~~                       ~~~~~                       ~ ~~~~~~~  ~~~~                 ~~~~~~~~          
~~~~~~~~~~~~~~~~~~~~~~~~~~~~~~~        ~~         ~ ~   ~~~~~~     ~~~~~                     ~~~~~~~~~~~~~~~~~~~ ~           ~~~~~~~~          
~~~~~~~~~~~~~~~~~~~~~~~~~~~~~~                   ~~~~~~~~~~ ~~~~       ~~~~~~               ~~~~~~~~~~~~~~~~~~~~~~~~      ~    ~~~~~           
~~~~~~~~~~~~~~~~~~~~~~~~~~~~~                ~~~~~~~~~~~~~  ~~~~~~~~~     ~~~       ~~~~   ~~~                                  ~~~            
~~~~~~~~~~~~~~~~~~~~~~~~~~~~               ~~~~~~~~~~~~~~  ~~~~~~~~~~~~  ~~~~~~    ~~~~~                                ~~  ~~~ ~~~~           
~~~~~~~~~~~~~~~~~~~~~~~~~~~~~             ~~~~~~~~~~~~~~~~~~~~~~~      ~~~~~~~~~~   ~~~~~~~                             ~~~~~~~~~~~~~          
~~~~~~~~~~~~~~~~~~~~~~~~~~~~~~~~       ~~~~~~~~~~~~~~~~~~~~~~~~~~~~~~~~~~~~~~~~~~~~~~~~~~~~~~~                                                 
~~~~~~~~~~~~~~~~~~~~~~~~~~~~~~~~~~~~~~~~~~~~~~~~~~~~~~~~~~~~~~~~~~~~~~~~~~~~~~~~~~~~~~~~~~~~~~~~                                               
~~~~~~~~~~~~~~~~~~~~~~~~~~~~~~~~~~~~~~~~~~~~~~~~~~~~~~~~~~~~~~~~~~~~~~~~~~~~~~~~~~~~~~~~~~~~~~~~~                                              