~~~~~~~~~~~~~~~~~~~~~~~~~~~~~~~~~~~~~~~~~~~~~~~~~~~~~~~~ ~~~~~~~~~~~~~~~~~~~~~~~~~~~~~~~~~~~~~~~~~~~~~~~~~~~~~~~~~~~~~~~~~~~~~~~~~~~~~~~~~~~~~~
~~~~~~~~~~~~~~~~~~~~~~~~~~~~~~~~~~  ~~~  ~~               ~~~~~~~~~~~~~~~~~~~~~~~~~~~~~~~~~~~~~~~~~~~~~~~~~~~~~~~~~~~~~~~~~~~~~~~~~~~~~~~~~~~~~
~~~~~~~~~~~~~~~~~~~~~~~~   ~~~~    ~   ~~~~~~~           ~~~~~~~~~~~~~~~~~~~~~~~~~~~~~~~~~~        ~  ~~ ~~~~~~~~~~~~~~~~~~~~~~~~~~~~~~~~~~~~~~
~~~~~~~~         ~     ~       ~ ~~ ~~   ~~~~~          ~~~~~~~~~~~~~~      ~~~~~~~~~ ~                                      ~~~~~~~~~~~~~~~~~~
~~~~                              ~~~~  ~ ~~~     ~~~~~    ~~~~~~~~~         ~                                                     ~~~~~~~~~~~~
~~                           ~~~~~~  ~~~~~~~~~  ~~~~~~~~~~~~~~~~~~    ~~                                                  ~ ~   ~~~~~~~~~~~~~~~
~~~ ~~~~~~~~                ~~~~~~      ~~~~~~~~~~~~~~~~~~~~~ ~~~~~~  ~~~                                             ~~~~~~   ~~~~~~~~~~~~~~~~
~~~~~~~~~~~~                   ~         ~~~~~~~~~~~~~~~~~~~ ~ ~~~~                                                   ~  ~~~~~ ~~~~~~~~~~~~~~~~
~~~~~~~~~~~                            ~ ~~~~~~~~~~~~~~~~~~~~ ~~                                                         ~~~~~~~~~~~~~~~~~~~~~~
~~~~~~~~~~~~             ~ ~        ~~~~~~~~~~~~~~~~~~~~~~~~~~                                                           ~~~~~~~~~~~~~~~~~~~~~~
~~~~~~~~~~                       ~~~~~~~~~~~~~~~~~~~~~~~~~~~      ~~ ~~    ~~~~~~   ~                                    ~~~  ~~~~~~~~~~~~~~~~~
~~~~~~~~~                      ~~~~~~~~~~~~~~~~~~~~~~~~~~~~    ~~~~~~~ ~ ~~          ~                             ~   ~~~~~ ~~~~~~~~~~~~~~~~~~
~~~~~~~~~                     ~~~~~~~~~~~~~~~~~~~~~~~~~~~~~~  ~     ~~~~~ ~~                                         ~~ ~~~  ~~~~~~~~~~~~~~~~~~
~~~~~~~~~~                 ~~~~~~~~~~~~~~~~~~~~~~~~~~~~~~~~           ~~~~~~~~~                                      ~~~~ ~~~~~~~~~~~~~~~~~~~~~
~~~~~~~~~~~~        ~~ ~~ ~~~~~~~~~~~~~~~~~~~~~~~~~~~~~~~~                           ~                                ~~~~~~~~~~~~~~~~~~~~~~~~~
~~~~~~~~~~~ ~     ~~~~~~~~~~~~~~~~~~~~~~~~~~~~~~~~~~~~~~                       ~       ~~                             ~~~~~~~~~~~~~~~~~~~~~~~~~
~~~~~~~~~~~~~~    ~~~~~~   ~~~~~~~~~~~~~~~~~~~~~~~~~~~~                         ~          ~~~~                     ~~~~~~~~~~~~~~~~~~~~~~~~~~~
~~~~~~~~~~~~~~      ~ ~~~~~~~  ~~~~~~~~~~~~~~~~~~~~~~~~                         ~~        ~~~~~~~     ~~~~~     ~ ~~~~~~~~~~~~~~~~~~~~~~~~~~~~~
~~~~~~~~~~~~~~~~~~      ~~~~~~~~~~~~~~~~~~~~~~~~~~~~~~~                          ~~    ~~~~~~~~~~   ~~~~~~~~~     ~~~~~ ~~~~~~~~~~~~~~~~~~~~~~~
~~~~~~~~~~~~~~~~~~~~~~   ~~~~ ~~~~~~~~~~~~~~~~~~~~~~~~~                            ~~~~~~~~~~~~~~~  ~~~~~~~~~ ~   ~~~~~~~~~~~~~~~~~~~~~~~~~~~~~
~~~~~~~~~~~~~~~~~~~~~~~~          ~~~~~~~~~~~~~~~~~~~~~~~                              ~~~~~~~~~~~~  ~~~~~~~~ ~~ ~~~~~ ~~~~~~~~~~~~~~~~~~~~~~~~
~~~~~~~~~~~~~~~~~~~~~~~~~~            ~~~~~~~~~~~~~~~~~~~~~ ~~~~~                     ~~~~~~~~~~~ ~~~~~~~~~~ ~  ~~~~~  ~~~~~~~~~~~~~~~~~~~~~~~~
~~~~~~~~~~~~~~~~~~~~~~~~~~             ~~~~~~~~~~~~~~~~~~~~~~~~~~~~                 ~~~~~~~~~~~~~~~~~~~~~~~~~   ~~~    ~~~~~~~~~~~~~~~~~~~~~~~~
~~~~~~~~~~~~~~~~~~~~~~~~~                 ~~~~~~~~~~~~~~~~~~~~~~~~~                ~~~~~~~~~~~~~~~~~~~~~~~~~~~  ~~~   ~  ~ ~  ~~ ~~~~~~~~~~~~~~
~~~~~~~~~~~~~~~~~~~~~~~~~                     ~~~~~~~~~~~~~~~~~~~~~~~            ~~~~~~~~~~~~~~~~~~~~~~~~~~~~~~~ ~~~~~~ ~~~~~~~~    ~~~~~~~~~~~
~~~~~~~~~~~~~~~~~~~~~~~~~~                    ~~~~~~~~~~~~~~~~~~~~~~~            ~~~~~~~~~~~~~~~~~~~~~~~~~~~~~~~~~~      ~ ~~~~~~ ~~ ~~~~~ ~~~~
~~~~~~~~~~~~~~~~~~~~~~~~~~~                  ~~~~~~~~~~~~~~~~~~~~~~~~             ~~~~~~~~~~~~~~~~~~~~~~~~~~~~~~~~~~~~~~~~~~~  ~~ ~~~~~~~~~~~~~
~~~~~~~~~~~~~~~~~~~~~~~~~~~~                 ~~~~~~~~~~~~~~~~~~~~~~~              ~~~ ~~~~~~~~~~~~~~~~~~~~~~~~~~~~~~~~~~~      ~~  ~~~~~~~~~~ ~
~~~~~~~~~~~~~~~~~~~~~~~~~~~~~~               ~~~~~~~~~~~~~~~~~~~~~~~~           ~~~   ~~~~~~~~~~~~~~~~~~~~~~~~~~~~~~~~~            ~~~~~~~~~~~~
~~~~~~~~~~~~~~~~~~~~~~~~~~~~~~              ~~~~~~~~~~~~~~~~~~~~~~~~~~         ~~~~  ~~~~~~~~~~~~~~~~~~~~~~~~~~~~~~~                ~~~~~~~~~~~
~~~~~~~~~~~~~~~~~~~~~~~~~~~~~~~          ~~~~~~~~~~~~~~~~~~~~~~~~~~~~~        ~~~~~~~~~~~~~~~~~~~~~~~~~~~~~~~~~~~~~                  ~~~~~~~~~~
~~~~~~~~~~~~~~~~~~~~~~~~~~~~~~~         ~~~~~~~~~~~~~~~~~~~~~~~~~~~~~~~      ~~~~~~~~~~~~~~~~~~~~~~~~~~~~~~~~~~~~~~                  ~~~~~~~~~~
~~~~~~~~~~~~~~~~~~~~~~~~~~~~~~~        ~~~~~~~~~~~~~~~~~~~~~~~~~~~~~~~~     ~~~~~~~~~~~~~~~~~~~~~~~~~~~~~~~~~~~~~~~    ~~~~        ~~~~~~~~~~~~
~~~~~~~~~~~~~~~~~~~~~~~~~~~~~~~       ~~~~~~~~~~~~~~~~~~~~~~~~~~~~~~~~~~~~~~~~~~~~~~~~~~~~~~~~~~~~~~~~~~~~~~~~~~~~~~~~~~~~~~~     ~~~~~~~~~~ ~~
~~~~~~~~~~~~~~~~~~~~~~~~~~~~~~~     ~~~~~~~~~~~~~~~~~~~~~~~~~~~~~~~~~~~~~~~~~~~~~~~~~~~~~~~~~~~~~~~~~~~~~~~~~~~~~~~~~~~~~~~~~~~~~~~~~~~~~~~ ~~~
~~~~~~~~~~~~~~~~~~~~~~~~~~~~~~~~    ~~~~~~~~~~~~~~~~~~~~~~~~~~~~~~~~~~~~~~~~~~~~~~~~~~~~~~~~~~~~~~~~~~~~~~~~~~~~~~~~~~~~~~~~~~~~~~~~~~~~ ~~~~~~
~~~~~~~~~~~~~~~~~~~~~~~~~~~~~~~~~   ~~~~~~~~~~~~~~~~~~~~~~~~~~~~~~~~~~~~~~~~~~~~~~~~~~~~~~~~~~~~~~~~~~~~~~~~~~~~~~~~~~~~~~~~~~~~~~~~~~~~~~~~~~~
~~~~~~~~~~~~~~~~~~~~~~~~~~~~~~~~~  ~~~~~~~~~~~~~~~~~~~~~~~~~~~~~~~~~~~~~~~~~~~~~~~~~~~~~~~~~~~~~~~~~~~~~~~~~~~~~~~~~~~~~~~~~~~~~~~~~~~~~~~~~~~~