~~~~~~~~~~~~~~~~~~~~~~~~~~~~~~~~~~~~~~~~~~~~~~~~~~~~~ ~~~~~~~~~~~~~~~~~~~~~~~~~~~~~~~~~~~~~~~~~~~~~~~~~~~~~~~~~~~~~~~~~~~~~~~~~~~~~~~~~~~~~~
~~~~~~~~~~~~~~~~~~~~~~~~~   ~~  ~ ~~~~~~~              ~~~~~~~~~~~~~~~~~~~~~~~~~~~~~~~~~~      ~~~~~~~~~~~~~~~~~~~~~~~~~~~~~~~~~~~~~~~~~~~~~
~~~~~~~~        ~~  ~ ~     ~~ ~~  ~   ~~~~~         ~~~~~~~~~~~~~~    ~~~~~~~~~ ~                                ~~ ~~~~~~~~~~~~~~~~~~~~~~~
~~~~~                         ~  ~~~  ~~~~~   ~~~~~~~  ~~~~~~~~~                                                          ~~~~~~~~~~~~~~~~~~
~~~ ~~~~~~~                ~~~~~      ~~~~~~~~~~~~~~~~~~~~ ~~~~~  ~~~                                          ~~~~~~~ ~~~~~~~~~~~~~~~~~~~~~
~~~~~~~~~~~                  ~         ~~~~~~~~~~~~~~~~~~    ~                                                     ~~~~ ~~~~~~~~~~~~~~~~~~~~
~~~~~~~~~~~              ~~       ~~~  ~~~~~~~~~~~~~~~~~~~~                                                        ~~~~~~~~~~~~~~~~~~~~~~~~~
~~~~~~~~~               ~      ~~~~~~~~~~~~~~~~~~~~~~~~~     ~~   ~~   ~~~~~~  ~~                                ~~~~~~~~~~~~~~~~~~~~~~~~~~~
~~~~~~~~~                   ~~~~~~~~~~~~~~~~~~~~~~~~~~~~   ~~~~~~~~~~~~          ~                             ~~ ~~~  ~~~~~~~~~~~~~~~~~~~~~
~~~~~~~~~~               ~~~~~~~~~~~~~~~~~~~~~~~~~~~~~~~          ~~  ~~~~~                                    ~~~~ ~~~~~~~~~~~~~~~~~~~~~~~~
~~~~~~~~~~ ~      ~~~~~~ ~~~~~~~~~~~~~~~~~~~~~~~~~~~~~                    ~      ~~                             ~~~~~~~~~~~~~~~~~~~~~~~~~~~~
~~~~~~~~~~~~~    ~~~~~~~~ ~~~~~~~~~~~~~~~~~~~~~~~~~~                        ~         ~~~~         ~         ~~~~~~~~~~~~~~~~~~~~~~~~~~~~~~~
~~~~~~~~~~~~~~~~     ~~~~~~~~~~~~~~~~~~~~~~~~~~~~~~~                         ~     ~~~~~~~~~    ~~~~~      ~~~~~~ ~~~~~~~~~~~~~~~~~~~~~~~~~~
~~~~~~~~~~~~~~~~~~~~~ ~~~~~  ~~~~~~~~~~~~~~~~~~~~~~~                           ~~~~~~~~~~~~~~  ~~~~~~~~ ~   ~~~~~~~~~~~~~~~~~~~~~~~~~~~~~~~~
~~~~~~~~~~~~~~~~~~~~~~~~~         ~~~~~~~~~~~~~~~~~~~~~                          ~~~~~~~~~~~~~~ ~~~~~~~~ ~~~~~~ ~~~ ~~~~~~~~~~~~~~~~~~~~~~~~
~~~~~~~~~~~~~~~~~~~~~~~~             ~~~~~~~~~~~~~~~~~~~~~~~~~~~               ~~~~~~~~~~~~~~~~~~~~~~~~~ ~~~    ~~~~~~~~~~~~~~~~~~~~~~~~~~~~
~~~~~~~~~~~~~~~~~~~~~~~                   ~~~~~~~~~~~~~~~~~~~~~~             ~~~~~~~~~~~~~~~~~~~~~~~~~~~~  ~~~~~~~~~ ~~     ~~~~~~~~~~~~~~~~
~~~~~~~~~~~~~~~~~~~~~~~~                    ~~~~~~~~~~~~~~~~~~~~~            ~~~~~~~~~~~~~~~~~~~~~~~~~~~~~~~~~~   ~ ~~~~~~ ~~ ~~~~~~~~~~~~~~
~~~~~~~~~~~~~~~~~~~~~~~~~~                ~~~~~~~~~~~~~~~~~~~~~~~             ~~~ ~~~~~~~~~~~~~~~~~~~~~~~~~~~~~~~~~~~   ~~ ~~~~~~~~~~~~~~~~~
~~~~~~~~~~~~~~~~~~~~~~~~~~~~~             ~~~~~~~~~~~~~~~~~~~~~~~          ~~~~  ~~~~~~~~~~~~~~~~~~~~~~~~~~~~~~~~           ~~~~~~~~~~~~~~~~
~~~~~~~~~~~~~~~~~~~~~~~~~~~~~          ~~~~~~~~~~~~~~~~~~~~~~~~~~~         ~~~~ ~~~~~~~~~~~~~~~~~~~~~~~~~~~~~                 ~~~~~~~~~~~~~~
~~~~~~~~~~~~~~~~~~~~~~~~~~~~~         ~~~~~~~~~~~~~~~~~~~~~~~~~~~~~      ~~~~~~~~~~~~~~~~~~~~~~~~~~~~~~~~~~~~                 ~~~~~~~~~~~~~~
~~~~~~~~~~~~~~~~~~~~~~~~~~~~~        ~~~~~~~~~~~~~~~~~~~~~~~~~~~~~~~ ~~~~~~~~~~~~~~~~~~~~~~~~~~~~~~~~~~~~~~~  ~~~~~~~~      ~~~~~~~~~~~~~~~~
~~~~~~~~~~~~~~~~~~~~~~~~~~~~~     ~~~~~~~~~~~~~~~~~~~~~~~~~~~~~~~~~~~~~~~~~~~~~~~~~~~~~~~~~~~~~~~~~~~~~~~~~~~~~~~~~~~~~~~~~~~~~~~~~~ ~~~~~~~
~~~~~~~~~~~~~~~~~~~~~~~~~~~~~~~   ~~~~~~~~~~~~~~~~~~~~~~~~~~~~~~~~~~~~~~~~~~~~~~~~~~~~~~~~~~~~~~~~~~~~~~~~~~~~~~~~~~~~~~~~~~~~~  ~~~~~~~~~~~
~~~~~~~~~~~~~~~~~~~~~~~~~~~~~~~   ~~~~~~~~~~~~~~~~~~~~~~~~~~~~~~~~~~~~~~~~~~~~~~~~~~~~~~~~~~~~~~~~~~~~~~~~~~~~~~~~~~~~~~~~~~~~~~~~~~~~~~~~~~